NO textures/matrix.xpm
SO textures/matrix.xpm
WE textures/matrix.xpm
EA textures/matrix.xpm

F 0,0,0
C 0,0,0

111111111111111111111111111111111111111
          10000000001100000000000000001
          10110000011100000011111111111
11111111110000000000000000011111
10110000011100N0000001111111
11111111100110000011101111111
11110111111111011100000010001
11110111111111010101010010001
11000000110101010100000010001
10000000000000001100000010001
10000000000000001100010000001
11000000110101000000000000001
11110111110101000000000000001
10000000001100000100000010001
10000000000000000000000001001
10000000111100010000000001001
10000000111100110101110000001
10000000111110000001110100001
11111111111111111111111111111

