NO ../2.png
SO ../2.png
WE ../2.png
EA ../2.png

F      17,    38,     64




C 218, 234, 235

1111111111111111111111111
10S0110000100000000000001
1000110000000000111111001
1000110000000000110001001
1000000000100000000001001
1111111111111111111111111
