NO ../2.png
SO ../2.png
WE ../2.png
EA ../2.png

F 220,100,0
C 225,30,0

1111111111111111111111111
1000000N000110000000000001
1011000001110000000000001
100100000000000000000000111111111
111111111011000001110000000000001
100000000011000001110111111111111
11110111111111011100000010001
11110111111111011101010010001
11000000110101011100000010001
10000000000000001100000010001
10000000000000001101010010001
11000011101010111110111100111
11110111 1110101 101111010001
11111111 1111111 111111111111