
F 20,     20,  	     20
C 200,200,200

NO textures/test/north.xpm
SO textures/test/south.xpm
WE textures/test/west.xpm
EA textures/test/east.xpm



11111                                   11111
10001                                   10001
10S01                                   11111
10001                                       
10001111                                     
10001                                      
11001                                       
10001                                        
10001                                        
10001                                       
10001                                     
10001               111                  
11111   
 
     N 
 
11111
10001
11111
