
F 20,     20,  	     20
C 200,200,200

NO textures/test/north.xpm
SO textures/test/south.xpm
WE textures/test/west.xpm
EA textures/test/east.xpm



11111                                  111111
10001                                   10001
10001             1111                  111111
10001             1S01                         
10001111          1111                        
10001                                      
11001                                       
10001                                        
10001                                        
10001                                       
10001                                     
10001               111                  
11111   
 
 
11111
10001
11111
